SO ./obj/wall/south.png
NO ./obj/wall/north.png
EA ./obj/wall/east.png
WE ./obj/wall/west.png
F ./obj/floor/floor.png
C ./obj/roof/roof.png


        1111111111111
     1111000000000001111
   11100000011100000000111
 111000000000000000000000111
 1110000000100000N0000000111
 110000000000100000000100011
 111000000000000000000000111
  1110000000000000100000111
   11100110000000000000111
     1111000000000001111
        1111111111111
