SO ./obj/wall/south.png
NO ./obj/wall/north.png
EA ./obj/wall/east.png
WE ./obj/wall/west.png
F ./obj/floor/floor.png
C ./obj/roof/roof.png


      111111111
     11000000011
    1100000000011
   110000000000011
   1100000N0000011
   110000000000011
    1100000000011
     11000000011
      111111111
