SO ./obj/wall/south.png
NO ./obj/wall/north.png
EA ./obj/wall/east.png
WE ./obj/wall/west.png
F ./obj/floor/floor.png
C ./obj/roof/roof.png

111111111111111111111111 111111111111
 100000000001000000000011000000001111
1111111111110000000000001000000000001
1001000000000000000000000000000000001
1111111111111111111111111111111111111

1111111111111111111111111111111111111
11111111101100000111000000N0000000001
1000000000110000011101111111111100001
1111011111111101110000001000100000001
1111011111111101110101001010100000011
110000001101010111000000100010000011
10000000000000001100000000001000011
1000000000000000110101001000100011
110000011101010111110111100010011
11110111 1110101 101111010001011
1111111111111111111111111111111
